[console_scripts]
branch = nodeps.__main__:_branch
browser = nodeps.__main__:_browser
build = nodeps.__main__:_build
buildrequires = nodeps.__main__:_buildrequires
builds = nodeps.__main__:_builds
clean = nodeps.__main__:_clean
commit = nodeps.__main__:_commit
completions = nodeps.__main__:_completions
current = nodeps.__main__:_current
dependencies = nodeps.__main__:_dependencies
dirty = nodeps.__main__:_dirty
distribution = nodeps.__main__:_distribution
diverge = nodeps.__main__:_diverge
docs = nodeps.__main__:_docs
extras = nodeps.__main__:_extras
g = nodeps.__main__:gh_g
ipy = nodeps.__main__:_ipy
ipythondir = nodeps.__main__:_ipythondir
latest = nodeps.__main__:_latest
mip = nodeps.__main__:_mip
needpull = nodeps.__main__:_needpull
needpush = nodeps.__main__:_needpush
next = nodeps.__main__:_next
p = nodeps.__main__:project_p
publish = nodeps.__main__:_publish
pull = nodeps.__main__:_pull
push = nodeps.__main__:_push
pypi = nodeps.__main__:_pypi
pytests = nodeps.__main__:_pytests
pythonstartup = nodeps.__main__:_pythonstartup
remote = nodeps.__main__:_remote
repos = nodeps.__main__:_repos
requirement = nodeps.__main__:_requirement
requirements = nodeps.__main__:_requirements
secrets = nodeps.__main__:_secrets
secrets-names = nodeps.__main__:_secrets_names
status = nodeps.__main__:_status
superproject = nodeps.__main__:_superproject
tests = nodeps.__main__:_tests
venv = nodeps.__main__:_venv
venvs = nodeps.__main__:_venvs
version = nodeps.__main__:_version

[pytest11]
git-pytest = nodeps.fixtures
